ID	Guide
Gene_A_1	GCCTACTACAGAGAAGCTG
Gene_A_2	AGGGCAGAATCCACAAACTG
Gene_A_3	AGGCCTACAGACACTCCCC
Gene_B_1	CAACTAGAGGGACAGGACG
Gene_B_2	CCTGTTACAGGATGACGGAG
Gene_B_3	CCTGCTCAACGGCGTCGCCA
Gene_C_1	TGAGGCAGAAGAGAGAGAGG
Gene_C_2	GGTAAGACAGTCTCAGCTG
Gene_C_3	GGTGGACACCAGCCAGCCA
Gene_D_1	CGAGGTATTCGGCTCCGCG
Gene_D_2	ATGTTGCAGTTCGGCTCGAT
Gene_D_3	ATTGTTCGACCGTCTACGGG
Gene_E_1	ACCCATCGGGTGCGATATGG
Gene_E_2	CAGCCACCGCACCGGCGTAA
Gene_E_3	TCAAGCCGAACGCTGCCGG
Gene_F_1	TTGTCAACTTCGGCCAACGC
Gene_F_2	AGAAAGGCACGTGCGACGTC
Gene_F_3	TCTCAGTTCGTAGCGAACGA
Gene_G_1	TATCCTCCTTACGGCCCGT
Gene_G_2	TTCGATGGCCGAGGACATTG
Gene_G_3	AGCGGTCCCCTATGTTCTGC
Gene_H_1	AGTACTGGTCGATGGCTTTC
Gene_H_2	ATTCAAGCTGTACTCGCCGA
Gene_H_3	ACCCCGGCACCATGCTGGAT
Gene_I_1	ACATACCTGGAGCCTGGGAT
Gene_I_2	TGTGTGACCATGACTACGAT
Gene_I_3	AAATCTGGAAAGCGTCACTT
Gene_J_1	AACAGAACGGAACAGACGAC
Gene_J_2	TCCCTCAGAGACATGGAGGC
Gene_J_3	ACCTGCAGTGCCGGCACCTC
Gene_K_1	CCATGGCTAGTCCCTGGAG
Gene_K_2	TGGCAATTATTATTATGGCC
Gene_K_3	CATAACTTGCTGCTAAATTA
Gene_L_1	TAACGTCGGAGAAGATTGTC
Gene_L_2	AACATTCAGGATGAGATCTT
Gene_L_3	CAACAGCTCTCCCCGAGTCC
Gene_M_1	ACCAAGAAGCCACCGGTCTC
Gene_M_2	TTTGCACAGATTCTCTAGT
Gene_M_3	TTTCTCTGCCTGCAGTCGAG
Gene_N_1	GCACTTGCTCAGGCAATCA
Gene_N_2	AGCAGACTGAAGGCCAACA
Gene_N_3	CACCTGCCAGCTGTCAACA
Gene_O_1	CAATGAGGCCTTGCATCCA
Gene_O_2	GGCTCCTGGTGGACCATGG
Gene_O_3	AAGAGGATGAGAAAGGTGA
Gene_P_1	CCAAACGCAGCCACTGCAG
Gene_P_2	CCGGGCCAGGGTCACAGCT
Gene_P_3	GGCCAAGTGTGCTCGACAG
Gene_Q_1	CAGTCCTTCCAAGGAAGCCA
Gene_Q_2	GGACCGCCATGACTGAAGT
Gene_Q_3	GACACCTACGCCCAAACAG
